
wwwwwwwwwwwwwww    wwwwwwwwwwwwwww
w             w  h w             w
w      m      w    w       m     w
w   wwwwwww   w    w   wwwwwww   w
w       k w   w    w   w  k      w
w    wwwwww   w    w   wwwwww    w
w    w                      w    w
w    w    m            m    w    w
w    wwwwwwwwwwwwwwwwwwwwwwww    w
w                                w
w      k                 k       w
wwwwwwwwwwwwwww    wwwwwwwwwwwwwww
w             w    w             w
w     m       w    w      m      w
w             w    w             w
w     m       w    w      m      w
w             w    w             w
w     www   www    www   www     w
w     w                    w     w
w     w                    w     w
w     wwwwwwwww    wwwwwwwww     w
w             wwwwww             w
w       k      wwww      k       w
wwwwwwwwwwwwww      wwwwwwwwwwwwww