
wwwwwwwwwwwwwwwwwwwwwwwwwwwwwwwwww
w                                w
w                          J     w
w                                w
w                                w
w                                w
w                                w
w                                w
w                                w
w                                w
w                                w
w                 f              w
                                 w
     h                           w
w                                w
w                                w
w                                w
w                                w
w                                w
w                                w
w      J                         w
w                                w
w                                w
wwwwwwwwwwwwwwwwwwwwwwwwwwwwwwwwww